{
  "default": 0,
  "map": {
    "S": {
      "417": 1,
      "439": 1,
      "446": 1,
      "449": 1,
      "453": 1,
      "455": 1,
      "456": 1,
      "475": 1,
      "486": 1,
      "488": 1,
      "493": 1,
      "496": 1,
      "498": 1,
      "500": 1,
      "501": 1,
      "502": 1,
      "503": 1,
      "505": 1
    }
  },
  "name": "ACE2"
}
